 ______________________________________________________________________________________________________________________ 
|                                                                                                           |          |
|                                                                                                         *****        |
|                                                                                                         *****        |
|                                                                                                         *****        |
|                                                                                                                      |
|                                                                                                           ___________|
|                                                                                                           |          |
|                                                                                                         *****        |
|                                                                                                         *****        |
|                                                                                                         *****        |
|                                                                                                                      |
|                                                                                                           ___________|
|                                                                                                           |          |
|                                                                                                         *****        |
|          \---/                                                                                          *****        |
|           \ /                                                                                           *****        |
|            |                                                                                                         |
|            |                                                                                                         |
|######################################################################################################################|
|######################################################################################################################|
|######################################################################################################################|
|######################################################################################################################|
|______________________________________________________________________________________________________________________|